2###0###0
6###1###0
1###2###0
120###3###0
121###4###0
122###5###0
123###0###1
124###1###1
19###2###1
200###3###1
201###4###1
202###5###1
203###0###2
204###1###2
205###2###2
4054 - Kopie###3###2
9###4###2
999###5###2
